name golden Map
win 5
###############
#.G.....G...#
#.....G.......#
#..G......####
##..G.....G..#
##..G......G.##
###############