name golden Map
win 3
###############
#.G.G...G...###
#G....G.......#
#..G.G....#####
##..G..G..G..##
##..G...G..G.##
###############